1111111111111
10C10000000C1
1000011111111
1P00111111E11
1111111111111
