111111111111111111111
1P0001000100010001001
101110101011101110101
100010001000100010001
111011111010111011111
100000001010000000001
101111101010001111101
101000100010001000101
101010111110101010101
1C1010000000101C10101
101011111110101110101
101010000010100000101
101010111010111110101
101010100010100C10111
101010101110101010111
1C1000101000101000111
101110101011101110101
100010001000100000001
111011101110111011101
10001000000000001C0E1
111111111111111111111
