11111111111111111111111111
1P0000000000000000000000C1
100000C1100001111111000001
10000011000001100C11000001
10000110000001000110000001
100011C0000000001100001101
10011111110000011001C01101
10011111110000110011000001
1000000C110001100111000001
10000000110001111111000111
1000000000000C0000000C00E1
11111111111111111111111111
