1111111111111
1C010C000C0C1
1000011111001
1P0C11E0C0001
1111111111111
